#useless_data;ahahah_nope;maybe;here;not_here;lost
q;h;y;n;p;z
q;h;y;c;p;z
q;h;y;f;p;z
q;h;y;d;p;z
q;h;y;z;p;z
q;h;y;a;p;z
q;h;y;t;p;z
q;h;y;m;p;z
q;h;y;i;p;z
q;h;y;k;p;z
q;h;y;v;p;z
q;h;y;l;p;z
q;h;y;e;p;z
q;h;y;s;p;z
q;h;y;j;p;z
q;h;y;b;p;z
q;h;y;o;p;z
q;h;y;p;p;z
q;h;y;r;p;z
q;h;y;q;p;z
q;h;y;x;p;z
q;h;y;u;p;z
q;h;y;h;p;z
q;h;y;w;p;z
q;h;y;j;p;z
q;h;y;h;p;z
q;h;y;a;p;z
q;h;y;q;p;z
q;h;y;z;p;z
q;h;y;d;p;z
q;h;y;c;p;z
q;h;y;v;p;z
q;h;y;w;p;z
q;h;y;b;p;z
q;h;y;y;p;z
q;h;y;m;p;z
q;h;y;l;p;z
q;h;y;p;p;z
q;h;y;u;p;z
q;h;y;x;p;z
q;h;y;k;p;z
q;h;y;t;p;z
q;h;y;f;p;z
q;h;y;o;p;z
q;h;y;s;p;z
q;h;y;r;p;z
q;h;y;i;p;z
q;h;y;n;p;z
q;h;y;g;p;z
q;h;y;d;p;z
q;h;y;n;p;z
q;h;y;y;p;z
q;h;y;z;p;z
q;h;y;i;p;z
q;h;y;o;p;z
q;h;y;s;p;z
q;h;y;a;p;z
q;h;y;r;p;z
q;h;y;v;p;z
q;h;y;j;p;z
q;h;y;h;p;z
q;h;y;e;p;z
q;h;y;l;p;z
q;h;y;m;p;z
q;h;y;f;p;z
q;h;y;g;p;z
q;h;y;p;p;z
q;h;y;x;p;z
q;h;y;c;p;z
q;h;y;k;p;z
q;h;y;u;p;z
q;h;y;b;p;z
q;h;y;t;p;z
q;h;y;w;p;z
q;h;y;q;p;z
q;h;y;w;p;z
q;h;y;h;p;z
q;h;y;t;p;z
q;h;y;x;p;z
q;h;y;b;p;z
q;h;y;k;p;z
q;h;y;r;p;z
q;h;y;n;p;z
q;h;y;e;p;z
q;h;y;y;p;z
q;h;y;p;p;z
q;h;y;d;p;z
q;h;y;o;p;z
q;h;y;j;p;z
q;h;y;z;p;z
q;h;y;f;p;z
q;h;y;m;p;z
q;h;y;s;p;z
q;h;y;v;p;z
q;h;y;c;p;z
q;h;y;l;p;z
q;h;y;a;p;z
q;h;y;u;p;z
q;h;y;q;p;z
